アメリカ	英語/えいご
フランス	フランス語/フランスご/仏語/仏蘭西語
中国	中国語/ちゅうごくご
ドイツ	ドイツ語/ドイツご/独逸語/独語
スペイン	スペイン語/スペインご
韓国	韓国語/かんこくご
グアム	英語/えいご/チャモロ語/チャモロご
ロシア	ロシア語/ロシアご
イタリア	イタリア語/イタリアご
ギリシャ	ギリシャ語/ギリシャご/ギリシア語/ギリシアご
ポルトガル	ポルトガル語/ポルトガルご
タイ	タイ語/タイご
イスラエル	ヘブライ語/ヘブライご/アラビア語/アラビアご
オランダ	オランダ語/オランダご
ベルギー	オランダ語/オランダご/フランス語/フランスご/ドイツ語/ドイツご
ブラジル	ポルトガル語/ポルトガルご
バングラデシュ	ベンガル語/ベンガルご
アルゼンチン	スペイン語/スペインご
オーストラリア	英語/えいご
イギリス	英語/えいご
オーストリア	ドイツ語/ドイツご
ボリビア	スペイン語/スペインご
カンボジア	クメール語/クメールご
カナダ	英語/えいご/フランス語/フランスご
キプロス	ギリシア語/ギリシアご/トルコ語/トルコご
チリ	スペイン語/スペインご
コロンビア	スペイン語/スペインご
フィジー	英語/えいご
デンマーク	デンマーク語/デンマークご/フェロー語/フェローご/グリーンランド語/グリーンランドご/ドイツ語/ドイツご
アンドラ	カタルーニャ語/カタルーニャご
台湾	中国語/ちゅうごくご
バハマ	英語/えいご
キューバ	スペイン語/スペインご
エクアドル	スペイン語/スペインご
エジプト	アラビア語/アラビアご
イラン	ペルシア語/ペルシアご
イラク	アラビア語/アラビアご/クルド語/クルドご
フィリピン	タガログ語/タガログご/フィリピノ語/フィリピノご/英語/えいご
スイス	ドイツ語/ドイツご/フランス語/フランスご/イタリア語/イタリアご/ロマンシュ語/ロマンシュご
ペルー	スペイン語/スペインご
パレスチナ	アラビア語/アラビアご
アイルランド	英語/えいご/アイルランド語/アイルランドご/ゲール語/ゲールご
オランダ	オランダ語/オランダご/フリジア語/フリジアご
シリア	アラビア語/アラビアご
メキシコ	スペイン語/スペインご
モロッコ	アラビア語/アラビアご/ベルベル語/ベルベルご
カザフスタン	カザフ語/カザフご/ロシア語/ロシアご
クウェート	アラビア語/アラビアご
ポーランド	ポーランド語/ポーランドご
