成田	千葉県
秩父	埼玉県
横浜	神奈川県
名古屋	愛知県
白馬	長野県
神戸	兵庫県
水戸	茨城県
北九州	福岡県
前橋	群馬県
浜松	静岡県
那覇	沖縄県
長岡	新潟県
郡山	福島県
宇都宮	栃木県
伊勢	三重県
大津市	滋賀県
仙台	宮城県
盛岡市	岩手県
高山市	岐阜県
弘前	青森県
橿原市	奈良県
米沢	山形県
防府	山口県
横手	秋田県
福山	広島県
甲府	山梨県
倉敷	岡山県
霧島	鹿児島県
阿蘇	熊本県
別府	大分県
小松	石川県
佐世保市	長崎県
宇和島	愛媛県
敦賀市	福井県
御坊	和歌山県
室戸	高知県
高岡	富山県
唐津	佐賀県
出雲	島根県
延岡	宮崎県
高松	香川県
米子	鳥取県
吉野川	徳島県
舞鶴	京都府
堺市	大阪府
八王子	東京都
札幌	北海道
