ヤフー	メール/オークション/ショップ/検索エンジン/けんさくエンジン/ポータルサイト/インターネット広告/広告/こうこく/ブロードバンド
ソニー	ゲーム/パソコン/電気製品/でんきせいひん/オーディオ機器/オーディオ/ビデオ機器/ビデオきき/テレビ/通信機器/つうしんき/半導体/はんどうたい/メディア
ドコモ	携帯/けいたい/通話/つうわ/メール/通信/つうしん/データ/インターネット/移動通信事業/いどうつうしんじぎょう/無線通信サービス/無線通信/むせんつうしん
マクドナルド	ハンバーグ/ポテトフライ/コーラ/食事/しょくじ/ファーストフード
日銀	口座/こうざ/銀行口座/ぎんこうこうざ/ローン/銀行/ぎんこう
フェラーリ	車/くるま/自動車/じどうしゃ/部品/ぶひん/自動車部品/じどうしゃぶひん/乗用車/じょうようしゃ/商用車/しょうようしゃ
ソフトバンク	携帯/けいたい/通話/つうわ/メール/通信/つうしん/データ/インターネット/移動通信事業/いどうつうしんじぎょう/無線通信サービス/無線通信/むせんつうしん
日産	車/くるま/自動車/じどうしゃ/日産自動車/にっさんじどうしゃ/部品/ぶひん/カー/乗用車/じょうようしゃ/商用車/しょうようしゃ
インテル	ハルドヴェア/プロセッサ/サーバー/半導体素子/はんどうたいそし/マイクロプロセッサ/チップセット/フラッシュメモリ
ベンツ	車/くるま/自動車/じどうしゃ/部品/ぶひん/カー/乗用車/じょうようしゃ/商用車/しょうようしゃ
日経	新聞/しんぶん/経済/けいざい/情報/じょうほう
三菱	車/くるま/自動車/じどうしゃ/部品/ぶひん/カー/乗用車/じょうようしゃ/商用車/しょうようしゃ
マイクロソフト	ソフトウェア/パソコン/ソフト/情報技術/じょうほうぎじゅつ
ダイエー	食品/しょくひん/衣料品/いりょうひん/生活用品/せいかつようひん/スーパーマーケット/スーパー
グーグル	メール/検索エンジン/けんさくエンジン/オンライン広告/オンラインこうこく/クラウドコンピューティング/ソフトウェア/ハードウェア/カレンダー/アシスタント/ドライバーレスカー
パナソニック	テレビ/カメラ/ファックス/パソコン/電話/でんわ/電気製品/でんきせいひん/カメラ/ヘッドホン/冷蔵庫/れいぞうこ/カーナビ/ヘアドライヤー
ファミリーマート	食品/しょくひん/飲料品/いんりょうひん/弁当/べんとう
ヤマハ	楽器/がっき/ピアノ/ドラム/バイオリン/トランペット/
ユニクロ	服/ふく/シャツ/パンツ/ジャケット/衣料品/いりょうひん
ノートン	ソフトヴェア/セキュリティ/ソフト
近鉄	電車/でんしゃ/移動/いどう/タクシー
資生堂	化粧品/けしょうひん/メイク/美容液/びようえき/化粧水/けしょうすい/クリーム/洗顔/せんがん/美白/びはく/ファンデーション/BBクリーム/日焼け止め/ひやけどめ/マスク/あぶらとり紙/あぶらとりがみ
トヨタ自動車	車/くるま/自動車/じどうしゃ/部品/ぶひん/カー/自動車部品/じどうしゃぶひん
ヤマト	配達/はいたつ/郵送/ゆうそう/出荷/しゅっか
日テレ	テレビ/番組/ばんぐみ/映画/えいが/ドラマ/時代劇/じだいげき/バラエティ番組/バラエティばんぐみ
朝日新聞	ニュース/記事/きじ/インフォメーション
テレビ朝日	テレビ/番組/ばんぐみ/映画/えいが/ドラマ
ポルシェ	車/くるま/自動車/じどうしゃ/自動車部品/じどうしゃぶひん
サントリー	飲料/いんりょう/飲料品/いんりょうひん/ビール/ジュース/ウイスキー
日立	テレビ/冷蔵庫/れいぞうこ/炊飯器/すいはんき/家電製品/かでんせいひん/通信システム/つうしんシステム/機器/きき
エルメス	アクセサリー/小物/こもの/ジュエリー/家具/かぐ/ハンドバッグ
スターバックスコーヒー	コーヒ/ケーキ/デザート
富士通	パソコン/タブレット/スマートフォン/ノートパソコン
ノンノ	ファッション/雑誌/ざっし
スカパー	デジタル/放送/ほうそう/テレビ/番組/ばんぐみ
ニッポン放送	ラジオ/音楽/おんがく
メルセデス	車/くるま/自動車/じどうしゃ/カー/部品/ぶひん
ナイキ	スポーツシューズ/ジャケット
マルコム	機器/きき
ナナコ	電子マネー/でんしマネー/プリペイド
グッチ	バッグ/アクセサリー/鞄/かばん/カバン
アディダス	靴/くつ/スポーツシューズ/シャツ
プラダ	バッグ/財布/さいふ/アクセサリー/財布/さいふ
ニコン	カメラ/一眼レフカメラ/いちがんレフカメラ/デジタルカメラ/デジカメ
ヴィトン	バッグ/財布/さいふ/アクセサリー/鞄/かばん/カバン
ホールデン	車/くるま/自動車/じどうしゃ
マツダ	車/くるま/自動車/じどうしゃ/自動車部品/じどうしゃぶひん
任天堂	ゲーム/ゲーム機/ゲームき
毎日新聞	ニュース/記事/きじ
吉野家	牛丼/ぎゅうどん/親子丼/おやこどん/丼/どんぶり/食事/しょくじ
