いそいそ	喜び/よろこび/嬉しさ/うれしさ
イライラ	嫌悪/けんお/怒り/いかり
いやいや	不愉快/ふゆかい/不快/ふかい/嫌/いや/仕方なく/しかたなく
ウキウキ	幸せ/しあわせ/幸福/こうふく/楽しさ/たのしさ/嬉しさ/うれしさ/喜び/よろこび
ウトウト	眠い/ねむい/眠気/ねむけ
うんうん	同意/どうい/肯定/こうてい/許可/きょか
おちおち	不安/ふあん/不安感/ふあんかん/心配/しんぱい
オロオロ	混乱/こんらん/狼狽える/うろたえる/驚き/おどろき/悲しみ/かなしみ
がっかり	落胆/らくたん/失望/しつぼう
ガミガミ	怒り/いかり/向かっ腹/むかっぱら/向っ腹/腹立/腹立ち/はらだち/憤り/いきどおり/怒気/どき
くすくす	笑い声/わらいこえ/笑い/わらい
くよくよ	心配/しんぱい/不安/ふあん/悩み/なやみ/悩む/なやむ
こんこん	怒り/いかり/向かっ腹/むかっぱら/向っ腹/腹立/腹立ち/はらだち/憤り/いきどおり/怒気/どき
チクチク	悲しみ/かなしみ/苦しみ/くるしみ
とつとつ	驚き/おどろき/怒り/いかり/悔しさ/くやっしさ
ドキドキ	緊張/きんちょう/恐怖/きょうふ/好き/すき/不安/ふあん/驚き/おどろき/興奮/こうふん/期待/きたい
さっぱり	安心/あんしん/すっきり
ざわざわ	騒がしい/さわがしい/賑やか/にぎやか/賑わう/にぎわう/賑わい/にぎわい
しくしく	悲しみ/かなしみ/悲しさ/かなしさ/哀しみ/悲哀/ひあい
しんみり	安堵/安ど/あんど/落ち着き/おちつき/ほっと
そわそわ	不安/ふあん/興奮/こうふん/不安感/ふあんかん/心配/しんぱい/ストレス
ニコニコ	微笑み/ほほえみ/笑い/わらい
ノリノリ	ご機嫌/ごきげん/ハイ/ハッピー
はっと	驚き/おどろき/ビックリ/びっくり
ピリピリ	緊張/きんちょう
ブルブル	恐怖/きょうふ/寒気/さむけ/恐怖感/きょうふかん
プンプン	怒り/いかり/向かっ腹/むかっぱら/向っ腹/腹立/腹立ち/はらだち/憤り/いきどおり/怒気/どき
へとへと	疲れる/疲れ/つかれる/つかれ/疲労/ひろう
ペコペコ	空腹/くうふく/飢える/うえる
ホクホク	喜び/よろこび/嬉しさ/うれしさ
もろもろ	多く/おおく/多い/おおい
もんもん	悩み/なやみ/悲しみ/かなしみ/悩み悲しむ/なやみかなしむ/悲しさ/かなしさ/悩む/なやむ
ムラムラ	立腹/りっぷく/怒り/いかり/向かっ腹/むかっぱら/向っ腹/腹立/腹立ち/はらだち/憤り/いきどおり/怒気/どき
らくらく	気楽/きらく/安心/あんしん/簡単/かんたん
ラブラブ	愛情/あいじょう/好き/すき/恋愛/れんあい
わくわく	興奮/こうふん/期待/きたい/喜び/悦び/よろこび
ワクワク	興奮/こうふん/期待/きたい/喜び/悦び/よろこび
ピカピカ	光る/ひかる/輝く/かがやく/光り輝く/ひかりかがやく/光/ひかり/輝き/かがやき
サバサバ	すっきり/爽やか/さわやか/あっさり
ヘトヘト	疲労/ひろう/疲れる/つかれる/疲れ/つかれ
やすやす	平穏/へいおん/安楽/あんらく/簡単/かんたん/容易く/たやすく
ペラペラ	自由/じゆう/流暢/りゅうちょう
ふわふわ	柔らかい/やわらかい/やわらか/柔らか/揺れる/ゆれる/浮かぶ/うかぶ
そわそわ	緊張/きんちょう/ストレス/落ち着か/おちつか
ゴタゴタ	混乱/こんらん/争い/あらそい/ごちゃごちゃ/紛争/ふんそう
ぽかぽか	暖かく/あたたかく/暖かさ/あたたかさ/暖かい/あたたかい/温/気持ちいい/きもちいい
ギラギラ	光/ひかり/光り輝く/ひかりかがやく/輝き/かがやき
ぶつぶつ	不平/ふへい/不満/ふまん
ビクビク	不安/ふあん恐れ/おそれ/落ち着か/おちつか/震え動く/ふるえうごく
ぐらぐら	不安定/ふあんてい/揺れる/ゆれる/動揺/どうよう
