アリ	茶色/ちゃいろ/黒/くろ/赤/あか/赤い/あかい/黒い/くろい/黄色/きいろ/褐色/かっしょく/赤色/あかいろ/グレー
あざ	青/あお/赤/あか
馬	茶色/ちゃいろ/黒/くろ/白/しろ
海	青/あお/緑色/りょくしょく/赤色/せきしょく/藍色/あいしょく/エメラルド色/エメラルドいろ
お茶	黄色/きいろ/緑色/りょくしょく
カエル	黄色/きいろ/黄緑色/きみどりいろ/黄緑/きみどり/りょくしょく/緑色
カラス	黒/くろ/黒い/くろい
紙	白/しろ/真っ白/まっしろ/黄色/きいろ/色/しょく/茶色/ちゃいろ
髪の毛	黒/くろ/茶色/ちゃいろ/金髪/きんぱつ/ゴールド/灰色/はいいろ/シルバー/紫/むらさき
カリフラワー	白色/はくしょく/クリーム色/クリームしょく/黄緑色/きみどりいろ
菊	白/しろ/白色/はくしょく/黄色/きいろ/淡色/たんしょく/濃紫色/のうむらさきいろ
キャベツ	緑/みどり/緑色/りょくしょく/紫色/むらさきいろ
キュウリ	緑色/りょくしょく/緑黄色/みどりきいろ
牛乳	白い/しろい/真っ白/まっしろ
雲	白色/はくしょく/灰色/はいいろ/白/しろ/真っ白/まっしろ
クリーム	黄白色/きはくしょく/白色/はくしょく/クリーム色/クリームしょく
コーヒー	黒/くろ/ブラック/真っ黒/まっくろ
紅茶	紅色/べにいろ/水色/みずいろ/琥珀色/こはくいろ/濃橙色/のうだいだいしょく/金色/きんいろ
さくら	ピンク/白色/はくしょく/淡紅色/たんべにいろ/濃紅色/のうこうしょく/紅紫色/こうししょく
砂糖	白い/しろい/ブラウン/茶色/ちゃいろ/白色/はくしょく/白/しろ
サファイア	青色/あおいろ/青紫色/あおむらさきいろ/黄色/きいろ/緑青/ろくしょう
塩	白/しろ/真っ白/まっしろ/ピンク/ピンク色/ピンクいろ
芝生	緑色/りょくしょく/茶色/ちゃいろ/緑/みどり
信号	青/あお/赤/あか/黄/き
ジャガイモ	黄色/きいろ/紫色/むらさきいろ/茶色/ちゃいろ/白色/はくしょく
炭	黒/くろ/灰色/はいいろ
空	青/あお/赤/あか/青い/あおい/青色/あおいろ
太陽	金色/きんいろ/赤/あか
大根	白/しろ/緑黄色/りょくおうしょく
血	真っ赤/まっか/赤/あか
チョコレート	ホワイト/茶色/ちゃいろ/ブラック/白/しろ/焦げ茶/こげちゃ
土	黒色/こくしょく/褐色/かっしょく/紅色/べにいろ/黄色土/きいろつち/赤褐色/せっかっしょく
人参	オレンジ色/オレンジしょく/赤色/せきしょく
葉っぱ	緑色/りょくしょく/茶色/ちゃいろ/黄色/きいろ/金色/きんいろ
バナナ	金/きん/黄色/きいろ
バラ	白い/しろい/赤い/あかい/白/しろ/赤/あか/ピンク/青/あお/紫/むらさき/黄色い/きいろい/黄色/きいろ
パセリ	緑色/りょくしょく
パソコン	白/しろ/黒/くろ/ピンク/シルバー
ヒマワリ	黄色/きいろ/紫/むらさき/赤色/あかいろ/白/しろ/黄色い/きいろい/ゴールド/オレンジ
ビール	琥珀/こはく/焦げ茶/こげちゃ/琥珀色/こはくいろ/オレンジ色/オレンジいろ/オレンジ
ぶどう	紫色/むらさきいろ/緑色/りょくしょく/銅色/どうしょく/紫色/むらさきいろ/赤色/あかいろ
ブロッコリー	緑/みどり/緑黄色/みどりきいろ
ホウレンソウ	緑/みどり/緑色/りょくしょく/緑黄色/みどりきいろ
マグロ	ピンク/ピンク色/ピンクしょく/黄色/きいろ
桃	白色/はくしょく/ピンク/黄色い/きいろい/黄色/きいろ/赤/あか
りんご	青/あお/赤/あか/青い/あおい/赤い/あかい/えんじ色/えんじいろ
林檎	青/あお/赤/あか/青い/あおい/赤い/あかい/えんじ色/えんじいろ/黄緑色/おうりょくしょく
ルビー	赤/あか/ピンク/ピンク色/ピンクいろ/小豆色/あずきいろ/真っ赤/まっか
ヨーグルト	白/しろ/白色/はくしょく
雪	白/しろ/真っ白/まっしろ
