椅子	家具/かぐ/ファニチャー/家什/かじゅう/ファーニチャー/インテリア/ファーニチュア/調度品/ちょうどひん/器具/きぐ/支え/ささえ/道具/どうぐ/人工物/じんこうぶつ/全体/ぜんたい/物/もの/実体/じったい
テーブル	家具/かぐ/ファニチャー/家什/かじゅう/ファーニチャー/インテリア/ファーニチュア/調度品/ちょうどひん/道具/どうぐ/人工物/じんこうぶつ/全体/ぜんたい/物/もの/実体/じったい
キュウリ	野菜/やさい/ベジタブル/蔬菜/そさい/草片/くさびら/青果/せいか/作物/さくもつ/食べ物/たべもの/ 固体/こたい/物質/ぶっしつ/実体/じったい
トマト	果実/かじつ/維管束植物/いかんそくしょくぶつ/維管_束_植物/いかん_そく_しょくぶつ/植物/しょくぶつ/草木/くさき/生物/せいぶつ/全体/ぜんたい/物/もの/実体/じったい
パソコン	コンピューター/コンピュータ/デジタルコンピューター/デジタル計算機/デジタル_コンピューター/電算機/でんさんき/計算機/けいさんき/電脳/でんのう/計算器/けいさんき/電算/でんさん/データプロセッサー/電子計算機/でんしけいさんき/マシン/マシーン/器械/きかい/機械/器具/きかい/きぐ/道具/どうぐ/人工物/じんこうぶつ/全体/ぜんたい/物/もの/実体/じったい
カメラ	道具/どうぐ/装置/そうち/設備/せつび/用品/ようひん/備品/びひん/機器/きき/機具/きぐ/機材/きざい/器機/エクィップメント/エクイップメント/イクイップメント/器具/きぐ/人工物/じんこうぶつ/全体/ぜんたい/物/もの/実体/じったい/アーチファクト/アーティファクト
写真	影像/映像/えいぞう/像/ぞう/創造物/そうぞうぶつ/人工物/じんこうぶつ/全体/ぜんたい/物/もの/実体/じったい
選手	競技者/きょうぎしゃ/競争者/きょうそうしゃ/競演者/きょうえんしゃ/人/ひと/人間/にんげん/原因物/げんいんもの/生き物/いきもの/総体/そうたい/実体/じったい
マスカラ	化粧/けしょう/化粧品/けしょうひん/チック/コスメチック/道具/どうぐ/人工品/じんこうひん/人工物/じんこうぶつ/全体/ぜんたい/物/もの/実体/じったい
サラダ	料理/りょうり/一品/いっぴん/栄養/えいよう/栄養物/えいようぶつ/営養素/えいようそ/栄養素/栄養分/えいようぶん/滋養分/じようぶん/営養/えいよう/滋養/じよう/精分/せいぶん/養い/やしない/養分/ようぶん/栄養物質/ぶっしつ/実体/じったい
車	自動車/じどうしゃ/モータービークル/車両/しゃりょう/道具/どうぐ/	乗り物/のりもの/輸送機関/ゆそうきかん/輸送_機関/ゆそう_きかん/アーチファクト/アーティファクト/人工物/じんこうぶつ
学生	受講者/じゅこうしゃ/学習者/人/ひと/人間/にんげん/原因物/げんいんもの/生き物/いきもの/全体/ぜんたい/生物/せいぶつ
日記	著作/ちょさく/記録/きろく/文書/ぶんしょ/コミュニケーション/著述/ちょじゅつ/著/ちょ/文章/ぶんしょう/文書/ぶんしょ/資料/しりょう/書き物/書きもの/かきもの/書物/コミニュケーション/コミュニケイション/通信/つうしん/コミュニケーション/聯絡/連絡/れんらく/抽象的実体/ちゅうしょうてきじったい/抽象的_実体/ちゅうしょうてき_じったい
お茶	飲料/いんりょう/飲み物/のみもの/飲み料/のみりょう/飲物/水物/すいぶつ/リクィッド/リキッド/液体/えきたい/リクイッド/液/えき/栄養/えいよう/物質/ぶっしつ/サブスタンス/物/もの/流体/りゅうたい
ジャケット	コート/上着/うわぎ/上衣/うえころも/外套/がいとう/外衣/がいい/オーバーコート/オーバ/上張り/うわばり/トップコート/襲/おすい/コート/オーバコート/オーバー/表着/アパレル/洋服/ようふく/衣類/いるい/ウェア/御召し物/お召し物/おめしもの/消費財/しょうひざい/品物/しなもの/商品/しょうひん
腕時計	時計/とけい/ウォッチ/ウオッチ/時辰儀/じしんぎ/測定装置/そくていそうち/測定_装置/そくてい_そうち/計器/けいき/器械/きかい/器具/きぐ/ツール/道具/どうぐ/用器/ようき/機器/きき/器械/機材/きかい/機械人工物/じんこうぶつ/全体/ぜんたい/物/もの/実体/じったい
ホッチキス	道具/どうぐ/文具/ぶんぐ/マシン/マシーン/器械/きかい/機械/機器/きき/器具/きぐ/装置/そうち/ツール/アーチファクト/人工物/じんこうぶつ/アーティファクト/全体/ぜんたい/物/もの
ブロッコリー	野菜/やさい/ベジタブル/蔬菜/そさい/草片/くさびら/青果/せいか/作物/さくもつ/食べ物/たべもの/個体/こたい/物質/ぶっしつ/実体/じったい
サファイア	宝玉/たからだま/宝珠/たからしゅ/宝石/ほうせき/ジェムストーン/ジェム/コランダム/鉱物/こうぶつ/砿物/こうもの/ミネラル/素材/そざい/材/ざい/材料/ざいりょう/原材料/げんざいりょう/物質/ぶっしつ
水	リキッド/流動体/りゅうどうからだ/液体/えきたい/水物/みずもの/液/えき/体液/たいえき/リキッド/漿液/しょうえき/流動体/りゅうどうたい/化合物/かごうぶつ/物質/ぶっしつ
靴	履物/はきもの/覆い/おおい/はき物/モカション/履きもの/履き物/人口物/じんこうもの/全体/ぜんたい
スカート	服/ふく/アパレル/御召し物/お召し物/おめしもの/着類/ちゃくるい/洋服/ようふく/衣類/いるい/衣装/いしょう/ウェア/衣/ころも/衣料/いりょう/衣服/いふく/覆い/おおい/人工物/じんこうぶつ/全体/ぜんたい/物/もの/実体/じったい
子供	人/ひと/個人/こじん/人間/にんげん/生体/せいたい/胤裔/いんえい/孫子/そんし/末ずえ/すえずえ/ばつえい/末裔/末孫/ばっそん/末末/末流/ばつりゅう/末々/子孫/しそん/葉末/はずえ/裔/えい/余裔/よえい/余胤/よいん/後昆/こうこん/後胤/こういん/後葉/こうよう/後裔/こうえい/児孫/じそん/苗裔/びょうえい/縁戚/えんせき/身寄/みより/縁故/えんこ/血族/けつぞく/親/しん/身より/みより/親類筋/しんるいすじ/眷族/けんぞく/縁者/えんじゃ/身寄り/縁辺/えんぺん/縁類/えんるい/肉縁/にくえん/眷属/けんぞく/族戚/ぞくせき/類縁/るいえん/親せき/しんせき/族親/ぞくしん/親戚/親族/しんぞく/親類/しんるい/親眷/生き物/いきもの/生物/せいぶつ
自転車	乗り物/のりもの/車/くるま/乗物/交通手段/こうつうしゅだん/交通_手段/こうつう_しゅだん/道具/どうぐ/物/もの
車椅子	椅子/いす/腰掛け/こしかけ/いす/腰かけ/腰掛/チェア/倚子/腰掛/チェア/具足/ぐそく/シート/居敷/居敷き/いしき/道具/どうぐ/人工物/じんこうぶつ/全体/ぜんたい/物/もの/実体/じったい
タルト	パイ/菓子/かし/食べ物/たべもの/食物/個体/こたい/物質/ぶっしつ/全体/ぜんたい/物/もの/実体/じったい
棚	家具/かぐ/支え/ささえ/支持物/しじもの/機器/きき/器具/きぐ/装置/そうち/ツール/道具/どうぐ/機器/器具/きき/装置/そうち/ツール/アーチファクト/アーティファクト/人工物/じんこうぶつ/全体/ぜんたい/物/もの/実体/じったい
ソファ	椅子/いす/腰掛け/こしかけ/いす/腰かけ/腰掛/チェア/具足/ぐそく/インテリア/ファーニチュア/家具/かぐ/道具/どうぐ/人工物/じんこうぶつ/全体/ぜんたい/物/もの/実体/じったい
歩道	通路/つうろ/道/みち/通り路/とおりみち/通り道/通路/人工物/じんこうぶつ/アーチファクト/アーティファクト全体/ぜんたい/物/もの/実体/じったい
ネックレス	ジュエリー/宝飾品/たからしょくひん/アンティーク_ジュエリー/飾り付け/かざりつけ/修飾/しゅうしょく/装飾/そうしょく/飾り物/かざりもの/飾りもの/飾り/かざり/人工物/じんこうぶつ/全体/ぜんたい/物/もの/実体/じったい
髪の毛	覆い/おおい/毛/け/蔽/へい/覆/ふく/蔽い/へいい/被い/カバー/被覆/ひふく/カヴァー/自然物/しぜんもの/全体/ぜんたい/物/もの/実体/じったい
目	感官/かんかん/受容体/じゅようたい/感覚受容器/かんかくじゅようき/レセプター/レセプタ/感覚器/かんかくき/感覚器官/かんかくきかん/器官/きかん/身体部位/しんたいぶい/分/ふん/部分/ぶぶん/パーツ/物/もの/実体/じったい
ケーブル	電線/でんせん/電力線/でんりょくせん/コンダクタ/機器/きき/器具/きぐ/装置/そうち/ツール/道具/どうぐ/人工物/じんこうぶつ/全体/ぜんたい/物/もの/実体/じったい
ナイフ	食器/しょっき/刃物/はもの/切り手/きりて/カッター/截断機/せつだんき/切断機/刃物/具/ぐ/用具/ようぐ/器財/きざい/物の具/もののぐ/器具/きぐ/器械/きかい/ツール/工具/こうぐ/手道具/てどうぐ/道具/どうぐ/人工物/じんこうぶつ/全体/ぜんたい/物/もの/実体/じったい
フォーク	食器/しょっき/切れ物/きれもの/切物/せつもの/品/ひん/物品/ぶっぴん/物/もの/品物/しなもの/もの/道具/どうぐ/人工物/じんこうぶつ/全体/ぜんたい/物/実体/じったい
道路	通路/つうろ/道/みち/線/せん/直線/ちょくせん/ライン/場/ば/場所/ばしょ/所/ところ/ロケーション/人工物/じんこうぶつ/全体/ぜんたい/物/もの/実体/じったい
公園	土地/とち/庭園/ていえん/遊園地/ゆうえんち/地理的地域/ちりてきちいき/地理的_地域/ちりてき_ちいき/エリア/エリヤ/地帯/ちたい/地域/ちいき/地方/ちほう/リージョン/区域/くいき/一帯/いったい/地点/ちてん/位置/いち/場/ば/場所/ばしょ/所/ところ/ロケーション/ところ
ドア	建具/たてぐ/座敷/ざしき/房室/ぼうしつ/ルーム/間/かん/室/しつ/お部屋/おへや/お座敷/おざしき/部屋/へや/御部屋/エリア/エリヤ/ゾーン/区劃/くかく/区画/区域/くいき/建造物/けんぞうぶつ/建築物/けんちくぶつ/ストラクチャ/建物/たてもの/工作物/こうさくもの/建築/けんちく/構築物/こうちくぶつ/人工物/じんこうぶつ/全体/ぜんたい/物/もの/実体/じったい
障子	建具/たてぐ/遮蔽/しゃへい/包隠/つつみいん/つつみ隠し/つつみかくし/蔽/へい/覆い/おおい/隠伏/いんふく/掩蔽/えんぺい/覆/ふく/掩護/えんご/目隠/めかくし/遮蔽物/しゃへいぶつ/目かくし/見隠し/けんかくし/蔽い/へいい/見隠/けんいん/被い/陰蔽/いんへい/壅蔽/ようへい/屏障/びょうしょう/目隠し/隠し/かくし/隠匿/いんとく/隠秘/いんひ/カヴァー/隠蔽/いんぺい/被せ/かぶせ/覆い/人工物/じんこうぶつ/全体/ぜんたい/物/もの/実体/じったい
はしご	道/みち/道具/どうぐ/桟道/さんどう/階段/かいだん/階/かい/梯子/はしご/梯/てい/御階/おかい/段段/梯子段/はしごだん/段梯子/だんはしご/階梯/かいてい/階段室/かいだんしつ/上がり段/あがりだん/人工物/じんこうぶつ/全体/ぜんたい/物/もの/実体/じったい
肉	食べ物/たべもの/食物/筋肉/きんにく/動物組織/どうぶつそしき/皮下組織/ひかそしき/身体部位/しんたいぶい/部分/ぶぶん/パーツ/固形/こけい/固体/こたい/ソリッド/物質/ぶっしつ
お菓子	御馳走/ごちそう/佳肴/かさかな/嘉肴/かこう/ごちそう/馳走/ちそう/食べ物/食物/たべもの/食品/しょくひん/嗜好品/しこうひん/営養素/えいようもと/栄養素/えいようそ/栄養物/えいようもの/栄養分/えいようぶん/滋養分/じようふん/営養/えいよう/滋養/じよう/養い/やしない/養分/ようぶん/栄養/物質/ぶっしつ
カボチャ	野菜/やさい/蔬菜/そさい/草片/くさへん/ベジタブル/青果/せいか/作物/さくもつ/食物/たべもの/食べ物/固形/こけい/固体/こたい/物質/ぶっしつ
赤ちゃん	お子様/おこさま/子/こ/子ども/こども/お子さん/おこさん/愛児/あいじ/子弟/してい/子供/こども/人/にん/人間/にんげん/有機体/ゆうきたい/生活体/せいかつからだ/生体/せいたい/生物/せいぶつ/生き物/いきもの/総体/そうたい
仕事	職業/しょくぎょう/職/しょく/稼業/かぎょう/活動/かつどう/アクティヴィティー/アクティビティ/アクティビティー/行動/こうどう/行為/こうい/抽象的実体/ちゅうしょうてきじったい/抽象的_実体/ちゅうしょうてき_じったい/実体/じったい
指輪	ジュエリー/装飾品/そうしょくひん/宝飾品/たからしょくひん/アンティークジュエリー/アンティークジュエリー/アンティーク_ジュエリー/アンティーク_ジュエリー/飾り付け/かざりつけ/修飾/しゅうしょく/装飾/そうしょく/飾りつけ/飾り物/かざりもの/飾りもの/飾り付け/修飾/飾物/しょくもの/飾付/しょくつき/人工物/じんこうぶつ/全体/ぜんたい/物/もの/実体/じったい
窓	建具/たてぐ/枠組み/わくぐみ/躯体/くからだ/屋台骨/やたいぼね/枠組/骨格/こっかく/フレームワーク/骨組/ほねぐみ/骨骼/ほねかく/骨組み/フレイム/フレーム/建造物/けんぞうぶつ/建築物/けんちくぶつ/機構/きこう/ストラクチャ/建物/たてもの/工作物/こうさくもの/建築/けんちく/構築物/こうちくぶつ/ストラクチャー/構造物/こうぞうぶつ/構造体/こうぞうたい/人工物/じんこうぶつ/全体/ぜんたい/物/もの/実体/じったい
ペン	筆記用具/ひっきようぐ/具/ぐ/用具/ようぐ/器財/きざい/器具/きぐ/ツール/工具/こうぐ/手道具/てどうぐ/道具/どうぐ/人工物/じんこうぶつ/全体/ぜんたい/物/もの/実体/じったい
警察	官府/かんふ/機関/きかん/行政機関/ぎょうせいきかん/組織/そしき/官衙/かんが/公社/こうしゃ/局/きょく/行政官庁/ぎょうせいかんちょう/庁/ちょう/政府機関/せいふきかん/政府_機関/せいふ_きかん/役所/やくしょ/行政機関/ぎょうせいきかん/行政_機関/ぎょうせい_きかん/編成単位/へんせいたんい/編成_単位/へんせい_たんい/ユニット/社会的単位/しゃかいてきたんい/社会的_単位/しゃかいてき_たんい/班/はん/団体/だんたい/機構/きこう/組職/くみしょく/組織/そしき/オーガナイゼーション/オーガニゼイション/社会集団/しゃかいしゅうだん/社会_集団/しゃかい_しゅうだん/集団/しゅうだん/グループ/抽象的実体/ちゅうしょうてきじったい/抽象的_実体/ちゅうしょうてき_じったい/実体/じったい/職員/しょくいん/人員/にんいん/団体/だんたい/機構/きこう/組職/そしき/オーガナイゼーション/オーガニゼイション/社会集団/しゃかいしゅうだん
親戚	人/ひと/人間/にんげん/縁戚/へりせき/身寄/みより/縁故/えんこ/血族/けつぞく/親/おや/身より/親類筋/しんるいすじ/眷族/けんぞく/縁者 /えんじゃ/身寄り/縁辺/えんぺん/縁類/へりるい/肉縁/にひｋくへり/眷属/族戚/ぞくせき/類縁/るいへり/親せき/したせき/族親/ぞくおや/親戚/しんせき/親族/しんぞく/親類/しんるい/親眷/おやけん/人間/にんげん/人/にん/有機体/ゆうきたい/生活体/せいかつからだ/生体/せいたい/生物/せいぶつ/生き物/いきもの/係り/かかわり/係わり/結びつき/むすびつき/結び付き/関連/かんれん/結付/むすびつき/繋がり/つながり/係わりあい/かかわりあい/縁故/えんこ/間/あいだ/連絡/れんらく/因縁/いんえん/連関/れんかん/繋り/つながり/結付き/むすびつき/縁/えん/所縁/しょえん/コネクション/リレーション/関わり/係わり合い/かかわりあい/関連性/かんれんせい/むすび付き/かかわり合い/関係/かんけい
