大気	ガス/酸素/さんそ/水素/すいそ/窒素/ちっそ/オゾン/オゾン層/オゾンそう/外気圏/がいきけん/中間圏/ちゅうかんけん/成層圏/せいそうけん/熱圏/ねつけん
バッグ	革/かわ/生地/きじ/布/ぬの/プラスチック
砂浜	砂/すな/シリコン/クォーツ/岩石/がんせき/小石/こいし/二酸化ケイ素/にさんかケイもと/二酸化_ケイ素/にさんか_ケイもと/シリカ
ビール	麦/むぎ/ホップ/米/コメ/コーンスターチ/小麦/こむぎ
体	肉体/にくたい/骨/ほね/筋肉/きんにく/血管/けっかん/細胞/さいぼう/サイボウ/水/みず
ブーツ	革/かわ/キャンバス/綿/きぬ/麻
ボトル	ガラス/プラシチック
碗	ガラス/チャイナ/アルミニウム/木製/もくせい/スチール/プラスチック/粘土/ねんど
箱	スズ/段ボール/だんぼーる/ツゲの木/ツゲのき/ツゲ_の_木/ツゲ_の_き
パン	小麦粉/こむぎこ/酵母/こうぼ
銅	銅/どう/スズ/Cu/原子番号＿29/げんしばんごう＿29/原子_番号＿29/げんし_ばんごう＿29
飴	砂糖/さとう/ヌガー/チョコレート/ジェラチン/糖蜜/とうみつ/シロップ/蜂蜜/はちみつ/果物/くだもの/ナッツ
チョコレート	ココア/豆/まめ/カカオ/ココア豆/ココアまめ/ココア豆
衣類	布/ぬの/革/かわ
曇	蒸気/じょうき/水/みず/水蒸気/すいじょうき
カクテル	酒/さけ/ジュース/水/みず/炭酸水/たんさんすい/コーラ/ジンジャーエール/ヴォッカ/ジン/カシス/ソーダ/オレンジジュース/グレープフルーツジュース/ガムシロップ/リキュール//
コンクリート	シリコン/セメント/水/みず/砂/すな/原子番号14/げんしばんごう14/原子_番号_14/げんし_ばんごう_14/si
机	木材/もくざい/金属/きんぞく/鋼鉄/こうてつ
ダイヤモンド	炭素/たんそ
取っ手	金属/きんぞく/鋼鉄/こうてつ/青銅/せいどう/木材/もくざい
旗	布/ぬの/紙/かみ
氷河	氷/こおり/水/みず/酸素/さんそ/水素/すいそ/h/h2o/水/砂/すな/原子番号8/げんしばんごう8/原子_番号_8/げんし_ばんごう_8/水/砂/原子番号1/げんしばんごう1/原子番号_1/げんしばんごう_1/o/水氷/みずこおり
グラス	シリコン/ケイシャ/ソーダー灰/ソーダーばい/石灰石/せっかいせき
家	レンガ/セメント/木材/もくざい/粘土/ねんど
氷	水/みず/酸素/さんそ/水素/すいそ/水/h2o/原子番号１/げんしばんごう１/原子番号_１/げんしばんごう_１/原子番号8/げんしばんごう8/原子_番号_8/げんし_ばんごう_8/h/o
つらら	氷/こおり/水/みず
ジャム	果物/くだもの/砂糖/さとう/ベリー/杏/あんず/ストロベリー/ブルーベリー/いちご/イチゴ/苺
ジーンズ	布/ぬの/デニム
芝生	草/くさ
レンズ	ガラス/プラスチック
鏡	ガラス/青銅/せいどう
お金	紙/かみ/金属/きんぞく/金/きん/銀/ぎん/鉄/てつ/銅/どう/スズ
大洋	水/みず/塩/しお
オムレツ	卵/たまご/牛乳/ぎゅうにゅう/チーズ/小麦粉/こむぎこ/野菜/やさい/オニオン/玉ねぎ/たまねぎ/トマト
ケーキ	小麦粉/こむぎこ/卵/たまご/バター/フィーリング
ペニー	金属/きんぞく/合金/ごうきん/青銅/せいどう/ニッケル/亜鉛/あえん/銅/どう/スズ
カプチーノ	コーヒー/ミルク/クリーム/牛乳/ぎゅうにゅう/ココアパウダー/シナモン/シナモンパウダー/チョコレートパウダー
プラスチック	ポリマー/油/あぶら/ガス/石炭/せきたん
屋根	屋根板/やねいた/タイル/木材/もくざい/金属/きんぞく
海	水/みず/塩/しお
雪	水/みず/酸素/さんそ/水素/すいそ/片/へん/氷/こおり/雪片/ゆきへん/h2o/原子番号1/げんしばんごう1/原子_番号_1/げんし_ばんごう_1/原子番号8/げんしばんごう8/原子_番号__8/げんし_ばんごう__8/h/o
スプーン	アルミニウム/木材/もくざい/鋼鉄/こうてつ
鋼鉄	鉄/てつ/真珠岩/しんじゅいわ/石炭/せきたん/セメンタイト/地鉄/ちてつ/fe/原子番号26/げんしばんごう26/原子_番号__26/げんし_ばんごう__26/アルファ鉄/アルファてつ
テーブル	木材/もくざい/プラスチック/金属/きんぞく
壁	セメント/レンガ/石/いし/木材/もくざい/段ボール/だんぼーる/板/いた/厚板/あつしいた/粘土/ねんど/泥/どろ
水	酸素/さんそ/水素/すいそ/水/みず/h2o/a原子番号1/aげんしばんごう1/a原子_番号_1/aげんし_ばんごう_1/原子番号8/げんしばんごう8/原子_番号__8/げんし_ばんごう__8/h/o
かつら	髪/かみ/髪の毛/かみのけ
ワイン	葡萄/ぶどう/ぶどう/グレープ
ワイヤー	金属/きんぞく/銅/どう/アルミニウム/銅合金/どうごうきん
ヨーグルト	牛乳/ぎゅうにゅう/菌/きん
