怖い	恐ろしい/おそろしい/もの恐ろしい/ものおそろしい/恐ろしげな/おそろしげな/ぞっとする/恐怖に襲われた/きょうふにおそわれた/恐怖_に_襲われた/きょうふ_に_おそわれた/おどろおどろしい/おっかない/恐れている/おそれている/茫然自失状態/ぼうぜんじしつじょうたい/茫然_自失_状態/ぼうぜん_じしつ_じょうたい/物すごい/ものすごい/凄い/すごい/すさまじい/凄まじい/非道い/ひどい/おどろおどろしい/凄じい/物凄い/おっかない/おぞましい/物恐ろしい/恐ろしげ/恐い/すごい/悍ましげ/酷い/悍ましい/物凄まじい
怒る	腹立つ/はらだつ/立腹/りっぷく/憤る怒り狂う/いきどおるいかりくるう/激怒/げきど/怒りつける/いかりつける/イライラする/猛然たる/もうぜんたる/怒りつける/おこりつける/叱りつける/叱り付ける/しかりつける/叱る/しかる/叱り飛ばす/しかりとばす/叱付ける/怒り付ける/おこりつける/叱飛ばす/叱りとばす/叱咤/しった/叱責/しっせき/叱する/譴責/けんせき/激怒する/激怒/げきど/憤怒する/ふんど/逆上する/逆上/ぎゃくじょう/むくれる/プンプンする/プンプン/プンスカする/プンスカ/ブチギレる/キレる/プッツンする/プッツン/カッとする/カッとなる/立腹する/りっぷくする/憤慨する/憤慨/ふんがい/激高する/げっこう/激高/カンカンになる/カンカン/マジギレする/激昂する/激昂/げきこう/怒り出す/おこりだす/忿怒/忿怒する/ふんど/ふんどする/取り上せる/取上せる/怒り心頭/いかりしんとう/プッツンする/かっとなる/かっとする/切れる/激する/興奮する/こうふんする/熱り立つ/いきり立つ/いきりだつ/いきまく/息巻く
聞く	問いただす/といただす/訊ねる/たずねる/問い掛ける/といかける/問合せる/といあわせる/問う/とう/伺う/うかがう/質問/しつもん/頼む/たのむ/願う/ねがう/お願い/おねがい/要求/ようきゅう/求める/もとめる/強要/きょうよう/問いただす/聴く/問掛ける/といかける/下問/したとい/尋く/聞き合わせる/ききあわせる/問あわせ/といあわせ/問いかける/借問/しゃもん/問いあわせる/質問/しつもん/尋ねる/たずねる/質す/ただす/訪う/糺す/仰ぐ/頼む/たのむ/乞う/請う/こう/願う/ねがう/もの問う/ものとう
悪い	酷い/ひどい/忌まわしげ/いまわしげ/憎ったらしい/にくったらしい/忌わしげ/きわしげ/大嫌い/だいきらい/憎らしい/ぞうらしい/忌ま忌ましい/いまいましい/憎々しい/ぞう々しい/憎憎しい/ぞうぞうしい/憎い/にくい/憎たらしい/にくたらしい/すさまじい/不良/ふりょう/まずい/へぼ/下手糞/へたくそ/こっ酷い/こっひどい/下手/へた/拙い/つたない/拙劣/せつれつ/ひどい/散々/さんざん/極悪/ごくあく/佞悪/ねいあく/兇悪/きょうあく/姦譎/かんきつ/獄道/ごくどう/よこしま/あくどい/悪らつ/あくらつ/奸譎/いけず/悪質/あくしつ/腹黒/はらぐろ/凶悪/罪作り/つみつくり/横道/おうどう/邪悪/じゃあく/邪/極道/ごくどう/邪曲/じゃきょく/腹黒い/はらぐろい/悪辣/邪ま/腹ぐろい
つまらない	退屈/たいくつ/くだらない/うんざりさせる/うんざり_させる/あきあきさせる/あきあき_させる/情趣のない/情趣がない/趣のない/趣がない/おもむきがない/面白味がない/おもしろみがない/面白味のない/おもしろみのない/情緒のない/情緒がない/風情のない/風情がない/殺風景な/さっぷうけいな/殺風景/さっぷうけい/殺風景の/さっぷうけいの/おかしみのない/おかしみがない/おかしさのない/おかしさがない/味わいのない/味わいがない/味気ない/味のない/ぎみない/無味な/無味乾燥な/やりがいのない/面白くない/奥行きの無い/無味乾燥の/無味乾燥/むみかんそう/情感のない/情感がない/味けない/コクがない/興ざめのする/シラケる/味気のない/大味な/潤いがない/退屈な/大味の/おおあじ/薄っぺらい/うすっぺらい/味もそっけもない/味気無い/あじけない
猫	ライオン/虎/とら/タイガー/ヒョウ/黒ヒョウ/くろヒョウ/ジャガー
笑う	ばか笑い/ばかわらい/一笑/いっしょう/爆笑/ばくしょう/大笑い/おおわらい/大爆笑/だいばくしょう/破顔一笑する/はがんいっしょう/破顔一笑
混乱	困惑/こんわく/困惑した/こんわくした/困惑_した/こんわく_した/迷った/まよった/当惑した/とうわくした/当惑_した/とうわく_した/惨憺たる/さんたんたる/狼狽/ろうばい/精神錯乱/せいしんさくらん/惑乱/わくらん/混濁/こんだく/錯乱/さくらん/精神的混乱/せいしんてきこんらん/不穏/ふおん/動揺/どうよう/不安/ふあん/激動/げきどう/不安心/ふあんしん/倉皇/そうこう/興奮/こうふん/亢奮/心騒ぎ/こころさわぎ/昂奮/狼藉/ろうじゃく/混迷/こんめい/乱脈/らんみゃく/乱雑/らんざつ/無秩序/むちつじょ/狂い/くるい/紛糾/ふんきゅう/渾沌/こんとん/当惑/とうわく/混同/こんどう/猥雑/わいざつ/雑駁/ざっぱく/ごたごた/混沌/めちゃ
創造力	クリエーティビティー/独創性/どくそうせい/イノベーション/発明/はつめい/革新/かくしん/オリジナリティ
泣く	叫ぶ/さけぶ/哀哭/あいこく/啼泣/ていきゅう/泣き叫ぶ/なきさけぶ/嘆く/なげく/弔う/とむらう/哀しむ/かなしむ/嘆じる/たんじる/悼む/ ・ /嘆ずる/たんずる/歎ずる/悲歎/ひたん/悲しがる/かなしがる/歎じる/悲嘆/ひたん/悔やむ/くやしむ/悔む/くやむ/愁傷/しゅうしょう/弔う/とむらう
食事	宴会/えんかい/パーティー/食事会/しょくじかい/祝筵/しゅくむしろ/祝宴/しゅくえん/賀宴/がうたげ/ごちそう/ご馳走様/御造作/ごぞうさく/馳走/ちそう/御雑作/ござつさく/饗膳/きょうぜん/雑作/ざつさく/ご造作/祝宴/しゅくえん/ご雑作/饗/あえ
苦手	嫌い/きらい/嫌厭/いやえん/嫌気/いやけ/悪感情/あくかんじょう/大嫌い/だいきらい/嫌/いや/嫌う/きらう/憎む/にくむ/忌嫌う/ききらう/怨む/毛ぎらい/忌む/厭う/毛嫌い/忌嫌う/憎悪/厭忌/厭悪/憎がる/唾棄/嫌う/嫌忌/毛嫌//しょうしつ/娼嫉/嫌悪/けんお/厭がる/忌諱/きい/嫌厭/けんえん/忌み嫌う/いみきらう/嫌/いや/忌みきらう/嫌がる/いやがる
居眠り	寝る/ねる/睡眠/すいみん/眠る/ねむる/就眠/しゅうみん
ワクワク	興奮/こうふん/動揺/どうよう/そわそわ/情熱/じょうねつ/熱情/ねつじょう/熱意/ねつい/熱血/ねっけつ/いき込み/いきこみ/狂熱/きょうねつ/強い興味/つよいこうふん/気組み/熱心/ねっしん/意気組み/いみくみ/気込み/熱気/意気込み/熱狂/ねっきょう/気勢/意気ごみ/熱中/忘我
信頼	信用/しんよう/信念/しんねん/信仰/しんこう/熱狂/ねっきょう/信念/しんねん
有罪	後悔/こうかい/悲惨/ひさん/下劣/げれつ/陰惨/いんさん/悲惨/ひさん/凄惨/無残/酸鼻/惨憺/惨澹
嬉しい	有頂天/うちょうてん/恍惚たる/こうこつたる/陶然たる/とうぜんたる/忽忽たる/こつこつたる/狂想的/きょうそうてき/熱狂的/ねっきょうてき/狂喜/きょうき/欣快/法悦/ほうえつ/大喜び/おおよろこび/歓天喜地
家	宮殿/きゅうでん/殿堂/でんどう/城/しろ/御殿/ごてん
空腹 	飢え/うえ/餓え/かつえ/餓え死/かつえし/餓死/がし
湖	海/うみ/大洋/たいよう
海	大洋/たいよう
好き	慈しむ/いつくしむ/あがめる/崇拝/すうはい/敬慕/けいぼ/あこがれる/熱愛/ねつあい/拝む/おがむ
猿	ゴリラ/大猩猩/だいじょうじょう/マウンテンゴリラ
昼寝	睡眠/すいみん/御寝/おね/就眠/しゅうみん/眠り/ねむり
痛み	激痛/げきつう/苦しみ/くるしみ/拷問/ごうもん/苦悩/くのう/苦痛/くつう
子馬	馬/うま/雄馬/おすうま/牡馬/馬匹/うまひき/ウマ
雨	豪雨/ごうう/大洪水/だいこうずい/氾濫/はんらん/大雨/おおあめ
軽食	食事/しょくじ/食べる/たべる/食う/くう/大食い/たいしょくい
まもなく	すぐ/早速/さっそく/直ち/ただち/逸速く/いつはやく
強い	力強い/ちからづよい/強力/きょうりょく/パワフル
美味しい	うまい/激ウマ/げきウマ/美味/びみ
ほしい	好ましい/このましい/願わしい/ねがわしい/望ましい/のぞましい/思わしい/おもわしい/欲望/よくぼう
温かい	暑い/あつい/ホット/蒸し暑い/むしあつい/猛暑/もうしょ/茹だる/ゆだる
徒歩	ジョギング/疾駆/しっく/突進/とっしん/駛走/しそう/ダッシ/疾走/しっそう/突撃/とつげき/驀進/ばくしん/ラッシュ
必要	肝要/かんよう/須要/すよう/不可欠/ふかけつ/肝/きも
悲しい	切ない/せつない/悲痛/ひつう/哀れ気/あわれき/もの悲しい/ものかなしい/うら悲しい/うらかなしい/物哀しい/哀しい/かなしい/沈痛/ちんつう/物悲しい/心悲しげ/こころかなしげ/心悲しい/こころかなしい/もの哀しい/苦しい/くるしい/物苦しい/ものくるしい
大きい	巨大/きょだい/でっかい/極大/きょくだい/最大/さいだい
小さい	ちび/ちっちゃい/極小/きょくしょう/最小/さいしょう
面白い	興味深い/きょうみぶかい/刺激的/しげきてき/エクサイティング/エキサイティング/比興/ひきょう/興奮させる/こうふんさせる
いい	素敵/すてき/凄い/すごい/もの凄い/ものすごい/ものすごい/物凄い/最高/さいこう
速い	素速い/もとはやい/激速/げきそく/最速/さいそく/疾い/はやい/迅速/じんそく
賢い	鋭い/するどい/利発/りはつ/賢明/けんめい/聡慧/さとしけい/悧巧/りこう/利口/怜悧/れいり/穎悟/えいさとし/明達/めいとおる/明哲/めいさとし
恥ずかしい	恥じ入る/はじいる/忸怩たる/じくじたる/腑甲斐ない/ふかいない
あざ	傷/きず/重傷/じゅうしょう/死亡/しぼう
知り合い	友達/ともだち/親友/しんゆう/幼馴染/ようなじみ/幼馴染み
若い	幼い/おさない/小さい/ちいさい/年少/ねんしょう/幼稚/ようち/稚い/ちい/ちっちゃい/子供/こども/赤ちゃん/あかちゃん/ベイビー
危ない	危険/きけん/重大/じゅうだい/深刻/しんこく/やばい/危い/あぶない/危うい/あぶなうい/深刻
呼吸	深呼吸/しんこきゅう/呼吸深大/こきゅうしんだい
可愛い	可愛がる/かわいがる/ちやほや/甘やかす/あまやかす
カサカサ	乾燥/かんそう/脱水/だっすい
